2/13/31
###############################
#                             #
# # # # # # # # # # # # # # # #
#                             #
# # # # # # # # # # # # # # # #
#                             #
# # # # # # # # # # # # # # # #
#                             #
# # # # # # # # # # # # # # # #
#                             #
# # # # # # # # # # # # # # # #
#                             #
###############################

Information to read the map correctly:

First line - level, height (tile), width (tile)h

Map Elements:
# - Fixed Wall
* - Destroyable Wall
space - Grass
x - Exit

Active Elements:
p - Player
e - Enemy (balloom)

Power Ups:
c - ClockUp
b - BombRange
s - SpeedUp
l - LifeUp
